##############################
#............#..............#
#..######....#....######....#
#..#....#....#....#....#....#
#..######....######....#....#
#.....................#.....#
######..###############..####
     #..#             #..#
     #..#  #########  #..#
######..####.......####..####
#............................#
##############################